+-+-+-+-+ +-+-+-+-+-+
|   |             | |
+ + + +-+-+-+ +-+ + +
| | |   |   | | |   |
+ +-+-+ +-+ + + + +-+
| |   |   | |   |   |
+ + + + + + + +-+ +-+
|   |   |   | |     |
+-+-+-+-+-+-+-+ +-+ +
|             |   | |
+ +-+-+-+-+ + +-+-+ +
|   |       |       |
+ + + +-+ +-+ +-+- -+
| | |   |  |  |     |
+ +-+-+ + +-+ + +-+ +
| |     | | | |   | |
+-+ +-+ + + + +-+ + +
|   |   |   |   | | |
+ +-+ +-+-+-+-+ + + +
|   |       |     | |
+-+-+-+-+-+ +-+-+-+-+